#gamemode
campaign

#background
src/Textures/background_lila.png

#map
w-w-w-w-w-w-w-w-w-w-w-w-w-w-w-w-w-w-w-w-w-w-w-w-w-w-w-w-w-w-w-w-w-w-w-w-w-w-w-w-w-w-w-w
w-.-.-.-.-.-.-.-.-Z-w-.-.-.-.-.-.-.-.-Z-.-.-.-.-Z-.-.-.-.-.-.-.-.-.-.-.-.-.-w-.-Z-.-.-w
w-P-.-.-.-.-.-.-.-Z-d-.-.-.-.-.-.-.-.-Z-.-.-.-.-Z-.-.-.-.-.-.-.-.-.-.-.-.-.-w-.-Z-.-.-w
w-.-.-.-.-.-.-.-.-Z-w-.-.-.-.-.-.-.-.-Z-.-.-.-.-Z-.-.-.-.-.-.-.-.-.-.-.-.-.-w-.-Z-.-.-w
w-w-w-w-w-w-w-w-w-w-w-w-w-w-w-w-w-w-w-w-w-w-w-w-w-w-w-w-w-w-d-d-d-w-w-w-w-w-w-w-d-d-w-w
w-w-.-.-.-w-w-w-w-w-w-w-w-w-w-w-w-w-w-w-w-w-w-.-w-.-w-w-w-w-.-.-.-w-w-w-w-w-w-w-.-.-w-w
w-w-Z-X-Z-w-w-w-w-w-w-w-w-w-w-w-w-w-w-w-w-w-w-.-w-.-w-w-w-w-.-.-.-w-w-w-w-w-w-w-.-.-w-w
w-w-.-.-.-w-w-w-w-w-w-w-w-w-w-w-w-w-w-w-w-w-w-.-w-.-w-w-w-w-.-.-.-w-w-w-w-w-w-w-.-.-w-w
w-w-w-.-w-w-w-w-w-w-w-w-w-w-w-w-w-w-w-w-w-w-w-w-w-w-w-w-w-w-Z-Z-Z-w-w-w-w-w-w-w-.-.-w-w
w-w-.-.-.-w-w-.-Z-Z-.-.-.-.-.-.-w-w-w-w-w-w-.-w-w-w-.-w-w-w-.-.-.-.-.-.-Z-.-Z-.-Z-.-w-w
w-w-.-Z-.-.-.-.-Z-Z-.-.-.-.-.-.-w-w-w-w-w-w-.-.-.-.-.-w-w-w-.-.-.-.-.-.-.-Z-.-Z-.-.-w-w
w-w-.-Z-.-.-.-.-Z-Z-.-.-.-.-.-.-w-w-w-w-w-w-w-w-w-w-w-w-w-w-w-w-d-d-w-w-w-w-w-w-w-w-w-w
w-w-w-w-w-w-w-.-Z-Z-.-.-.-.-.-.-w-w-w-w-w-w-w-w-w-w-w-w-w-w-w-w-d-d-w-w-w-w-w-w-w-w-w-w
w-w-w-w-w-w-w-w-w-w-w-w-w-w-.-.-w-w-w-w-w-w-w-w-w-w-w-w-w-w-w-w-d-d-w-w-w-w-w-w-w-w-w-w
w-w-w-w-w-w-w-w-w-w-w-w-w-w-.-.-w-w-w-w-w-w-w-w-w-w-w-w-w-w-w-.-.-.-.-w-w-w-w-w-w-w-w-w
w-w-w-w-w-.-.-.-.-.-w-w-w-w-Z-.-w-w-w-w-w-w-w-w-w-w-w-w-w-w-w-.-.-.-.-w-w-w-w-w-w-w-w-w
w-w-w-w-w-.-.-.-d-d-w-w-w-w-.-.-w-w-w-w-w-w-w-w-w-w-w-w-w-w-w-.-.-.-.-w-w-w-w-w-w-w-w-w
w-w-w-w-w-B-.-.-d-d-.-.-.-.-.-.-w-w-w-w-.-.-.-Z-.-.-.-.-.-.-.-Z-Z-Z-Z-.-w-w-w-w-w-w-w-w
w-w-w-w-w-.-.-.-d-d-w-w-w-w-.-.-d-d-d-d-.-.-Z-Z-Z-.-.-.-.-.-.-.-.-.-.-.-w-w-w-w-w-w-w-w
w-w-w-w-w-.-.-.-.-.-w-w-w-w-w-w-w-w-w-w-.-.-.-Z-.-.-.-.-.-.-.-Z-Z-Z-Z-.-w-w-w-w-w-w-w-w
w-w-w-w-w-w-w-w-w-w-w-w-w-w-w-w-w-w-w-w-w-w-w-w-w-w-w-w-w-w-w-w-w-w-w-w-w-w-w-w-w-w-w-w
w-w-w-w-w-w-w-w-w-w-w-w-w-w-w-w-w-w-w-w-w-w-w-w-w-w-w-w-w-w-w-w-w-w-w-w-w-w-w-w-w-w-w-w
